1111111111111111111111111
1000000000000000000000001
1011110111101011110111101
1011110111101011110111101
1000000000101010000000001
1011111010000000101111101
1000000010111110100000001
1011111010001000101111101
1000000011101011100000001
1111111010000000101111111
1000011010110110101100001
1011011010100010101101101
1000000000100010000000001
1011011010111110101101101
1000011010000000101100001
1111111010111110101111111
1000000000000000000000001
1011101011101011101011101
1011101000000000001011101
1000001011111111101000001
1111101000011100001011111
1000000011011101100000001
1011111111011101111111101
1000000000000000000000001
1111111111111111111111111

1110111111110111111110111
0000000000000000000000000
1011110111101011110111101
1011110111101011110111101
1000000000101010000000001
1011111010000000101111101
1000000010111110100000001
1011111010001000101111101
1000000011101011100000001
1111111010000000101111111
1000011010110110101100001
1011011010100010101101101
0000000000100010000000000
1011011010111110101101101
1000011010000000101100001
1111111010111110101111111
1000000000000000000000001
1011101011101011101011101
1011101000000000001011101
1000001011111111101000001
1111101000011100001011111
1000000011011101100000001
1011111111011101111111101
0000000000000000000000000
1110111111110111111110111

1110111111110111111110111
0000000000000000000000000
1011110111101011110111101
1011110111101011110111101
1000000000101010000000001
1011111010000000101111101
1000000010111110100000001
1011111010001000101111101
1000000011101011100000001
1111111010000000101111111
1000011010110110101100001
1011011010100010101101101
0000000000100010000000000
1011011010111110101101101
1000011010000000101100001
1111111010111110101111111
1000000000000000000000001
1011101011101011101011101
1011101000000000001011101
1000001011111111101000001
1111101000011100001011111
1000000011011101100000001
1011111111011101111111101
0000000000000000000000000
1110111111110111111110111

1110111111110111111110111
0000000000000000000000000
1011110111101011110111101
1011110111101011110111101
1000000000101010000000001
1011111010000000101111101
1000000010111110100000001
1011111010001000101111101
1000000011101011100000001
1111111010000000101111111
1000011010110110101100001
1011011010100010101101101
0000000000100010000000000
1011011010111110101101101
1000011010001000101100001
1111111010111110101111111
1000000000000000000000001
1011101011101011101011101
1011101000000000001011101
1000001011111111101000001
1111101000011100001011111
1000000011011101100000001
1011111111011101111111101
0000000000000000000000000
1110111111110111111110111

1110111111110111111110111
0000000000000000000000000
1011110111101011110111101
1011110111101011110111101
1000000000101010000000001
1011111010000000101111101
1000000010111110100000001
1011111010001000101111101
1000000011101011100000001
1111111010000000101111111
1000011010110110101100001
1011011010100010101101101
0000000000100010000000000
1011011010111110101101101
1000011010000000101100001
1111111010111110101111111
1000000000000000000000001
1011101011101011101011101
1011101000000000001011101
1000001011111111101000001
1111101000011100001011111
1000000011011101100000001
1011111111011101111111101
0000000000000000000000000
1110111111110111111110111

1111111111111111111111111
1000000000000000000000001
1011110111101011110111101
1011110111101011110111101
1000000000101010000000001
1011111010000000101111101
1000000010111110100000001
1011111010001000101111101
1000000011101011100000001
1111111010000000101111111
1000011010110110101100001
1011011010100010101101101
1000000000100010000000001
1011011010111110101101101
1000011010000000101100001
1111111010111110101111111
1000000000000000000000001
1011101011101011101011101
1011101000000000001011101
1000001011111111101000001
1111101000011100001011111
1000000011011101100000001
1011111111011101111111101
1000000000000000000000001
1111111111111111111111111
